%%%%%%%%%
%R      %
%  %%%%%%
%      %%
%  % T %%
%  %   %%
%  %M  %%
%  %S  %%
%  %%%%%%
%       %
%%%%%%%%%
